오리온자리=Orion
나침반자리=Pyxis
안드로메다자리=Andromeda
공기펌프자리=Antlia
극락조자리=Apus
독수리자리=Aquila
제단자리=Ara
양자리=Aries
마차부자리=Auriga
목동자리=Bootes
조각칼자리=Caelum
기린자리=Camelopardalis
게자리=Cancer
사냥개자리=Canes Venatici
큰개자리=Canis Major
작은개자리=Canis Minor
염소자리=Capricornus
용골자리=Carina
카시오페이아자리=Cassiopeia
센타우루스자리=Centaurus
세페우스자리=Cepheus
고래자리=Cetus
카멜레온자리=Chamaeleon
컴퍼스자리=Circinus
비둘기자리=Columba
머리털자리=Coma Berenices
남쪽왕관자리=Corona Australis
북쪽왕관자리=Corona Borealis
까마귀자리=Corvus
컵자리=Crater
남십자자리=Crux
고니자리=Cygnus
돌고래자리=Delphinus
황새치자리=Dorado
용자리=Draco
조랑말자리=Equuleus
에리다누스자리=Eridanus
화로자리=Fornax
쌍둥이자리=Gemini
두루미자리=Grus
헤르쿨레스자리=Hercules
시계자리=Horologium
바다뱀자리=Hydra
물뱀자리=Hydrus
인디언자리=Indus
도마뱀자리=Lacerta
사자자리=Leo
작은사자자리=Leo Minor
토끼자리=Lepus
천칭자리=Libra
이리자리=Lupus
살쾡이자리=Lynx
거문고자리=Lyra
테이블산자리=Mensa
현미경자리=Microscopium
외뿔소자리=Monoceros
파리자리=Musca
직각자자리=Norma
팔분의자리=Octans
공작자리=Pavo
페가수스자리=Pegasus
페르세우스자리=Perseus
봉황자리=Phoenix
화가자리=Pictor
남쪽물고기자리=Piscis Austrinus
고물자리=Puppis
그물자리=Reticulum
화살자리=Sagitta
궁수자리=Sagittarius
전갈자리=Scorpius
조각가자리=Sculptor
방패자리=Scutum
뱀자리=Serpens
육분의자리=Sextans
황소자리=Taurus
망원경자리=Telescopium
삼각형자리=Triangulum
남쪽삼각형자리=Triangulum Australe
큰부리새자리=Tucana
큰곰자리=Ursa Major
작은곰자리=Ursa Minor
날치자리=Volans
작은여우자리=Vulpecula
처녀자리=Virgo
사분의자리=Quadrans Muralis
작은삼각형자리=Triangulum Minus
뱀주인자리=Ophiuchus
물병자리=Aquarius
물고기자리=Pisces
돛자리=Vela
